WE ./image/path_to_the_west_texture.xpm

EA ./image/path_to_the_east_texture.xpm

NO ./image/path_to_the_north_texture.xpm

SO ./image/path_to_the_south_texture.xpm

F 139,69,19

C 135,206,235

1111111111111111111111111111111
1111110001100000000001100000001
1111111111111111111111111111111
1111111111111111111111111111111
1110000111111111111101100000001
10000000001        111100001111
11100001111        101100000001
11100001111        111101000001
11000000111        101100010001
10000S0000111111111101100100011
1000011110000111000001101110111
1000001110101010111111101111011
1110000000011010110111111010001
1111111111111111111111111111111